r100-100-500-200-
r600-100-800-200-
r800-200-900-800-
r200-800-800-900-
r100-100-200-800-
r0-0-999-39-
r960-0-999-999-
r0-960-999-999-
r0-0-39-999-
t500-500-
d300-300-600-400-