r100-100-800-200-
r800-200-900-800-
r200-800-800-900-
r100-100-200-800-
s450-450-550-550-
c500-500-50-